10 10 1
7 9
2 2
##########
#.#......#
#...###..#
###..#...#
#.##.#.###
#..#...#.#
##...#...#
#..#.###.#
#..#..#..#
#######.##