10 10 2
7 9
2 2
#.########
#.#......#
#...###..#
###..#...#
#.##.#.###
#..#...#.#
##...#...#
#..#.###.#
#..#..#..#
#######.##

1011111111
1010000001
1000111001
1110010001
1011010111
1001000101
1100010001
1001011101
1001001001
1111111011