15 10 2
13 9
3 2
#.#############
#.#.......#...#
#...###..###..#
#.#..#........#
#.##.#.##..####
#..#...#......#
##...#.... ####
#..#.###......#
#..#..#..#....#
#############.#