10 10
# ########
# #      #
#   ###  #
###  #   #
# ## # ###
#  #   # #
##   #   #
#  # ### #
####  ## #
#     #  #
####### ##